1111111111111111
1100000000000011
1100000000000011
1100000000000011
1100000000000011
1100000000000011
11000000000PCE11
1111111111111111